# from 'http://www.innovebioinfo.com/Database/SMDB/sample_file/ICGC.html'
Project Code: Project Name(Primary Site,Country)
ICGC-ALL-US: Acute Lymphoblastic Leukemia - TARGET, US(Blood,United States)
ICGC-AML-US: Acute Myeloid Leukemia - TARGET, US(Blood,United States)
ICGC-BLCA-CN: Bladder Cancer - CN(Bladder,China)
ICGC-BLCA-US: Bladder Urothelial Cancer - TCGA, US(Bladder,United States)
ICGC-BOCA-FR: Soft Tissue cancer - Ewing sarcoma - FR(Bone,France)
ICGC-BOCA-UK: Bone Cancer - UK(Bone,United Kingdom)
ICGC-BPLL-FR: B-Cell Prolymphocytic Leukemia(Blood,France)
ICGC-BRCA-EU: Breast ER+ and HER2- Cancer - EU/UK(Breast,European Union, United Kingdom)
ICGC-BRCA-FR: Breast Cancer - FR(Breast,France)
ICGC-BRCA-KR: Breast Cancer - Very young women(Breast,South Korea)
ICGC-BRCA-UK: Breast Triple Negative/Lobular Cancer - UK(Breast,United Kingdom)
ICGC-BRCA-US: Breast Cancer - TCGA, US(Breast,United States)
ICGC-BTCA-JP: Biliary Tract Cancer - JP(Gall Bladder,Japan)
ICGC-BTCA-SG: Biliary Tract Cancer - SG(Gall Bladder,Singapore)
ICGC-CESC-US: Cervical Squamous Cell Carcinoma - TCGA, US(Cervix,United States)
ICGC-CLLE-ES: Chronic Lymphocytic Leukemia - ES(Blood,Spain)
ICGC-CMDI-UK: Chronic Myeloid Disorders - UK(Blood,United Kingdom)
ICGC-COAD-US: Colon Adenocarcinoma - TCGA, US(Colorectal,United States)
ICGC-COCA-CN: Colorectal Cancer - CN(Colorectal,China)
ICGC-DLBC-US: Lymphoid Neoplasm Diffuse Large B-cell Lymphoma - TCGA, US(Blood,United States)
ICGC-EOPC-DE: Early Onset Prostate Cancer - DE(Prostate,Germany)
ICGC-ESAD-UK: Esophageal Adenocarcinoma - UK(Esophagus,United Kingdom)
ICGC-ESCA-CN: Esophageal Cancer - CN(Esophagus,China)
ICGC-GACA-CN: Gastric Cancer - CN(Stomach,China)
ICGC-GACA-JP: Gastric Cancer - JP(Stomach,Japan)
ICGC-GBM-US: Brain Glioblastoma Multiforme - TCGA, US(Brain,United States)
ICGC-HNSC-US: Head and Neck Squamous Cell Carcinoma - TCGA, US(Head and neck,United States)
ICGC-KICH-US: Kidney Chromophobe - TCGA, US(Kidney,United States)
ICGC-KIRC-US: Kidney Renal Clear Cell Carcinoma - TCGA, US(Kidney,United States)
ICGC-KIRP-US: Kidney Renal Papillary Cell Carcinoma - TCGA, US(Kidney,United States)
ICGC-LAML-CN: Leukemia - CN(Blood,China)
ICGC-LAML-KR: Acute Myeloid Leukemia - KR(Blood,South Korea)
ICGC-LAML-US: Acute Myeloid Leukemia - TCGA, US(Blood,United States)
ICGC-LGG-US: Brain Lower Grade Glioma - TCGA, US(Brain,United States)
ICGC-LIAD-FR: Benign Liver Tumour - FR(Liver,France)
ICGC-LICA-CN: Liver Cancer - CN(Liver,China)
ICGC-LICA-FR: Liver Cancer - FR(Liver,France)
ICGC-LIHC-US: Liver Hepatocellular carcinoma - TCGA, US(Liver,United States)
ICGC-LIHM-FR: Liver Cancer - Hepatocellular macronodules(Liver,France)
ICGC-LINC-JP: Liver Cancer - NCC, JP(Liver,Japan)
ICGC-LIRI-JP: Liver Cancer - RIKEN, JP(Liver,Japan)
ICGC-LMS-FR: Soft tissue cancer - Leiomyosarcoma(Mesenchymal,France)
ICGC-LUAD-US: Lung Adenocarcinoma - TCGA, US(Lung,United States)
ICGC-LUSC-CN: Lung Cancer - CN(Lung,China)
ICGC-LUSC-KR: Lung Cancer - KR(Lung,South Korea)
ICGC-LUSC-US: Lung Squamous Cell Carcinoma - TCGA, US(Lung,United States)
ICGC-MALY-DE: Malignant Lymphoma - DE(Blood,Germany)
ICGC-MELA-AU: Skin Cancer - AU(Skin,Australia)
ICGC-NACA-CN: Nasopharyngeal cancer - CN(Nasopharynx,China)
ICGC-NBL-US: Neuroblastoma - TARGET, US(Nervous System,United States)
ICGC-NKTL-SG: Blood Cancer - T-cell and NK-cell lymphoma - SG(Blood,Singapore)
ICGC-ORCA-IN: Oral Cancer - IN(Head and neck,India)
ICGC-OV-AU: Ovarian Cancer - AU(Ovary,Australia)
ICGC-OV-US: Ovarian Serous Cystadenocarcinoma - TCGA, US(Ovary,United States)
ICGC-PAAD-US: Pancreatic Cancer - TCGA, US(Pancreas,United States)
ICGC-PACA-AU: Pancreatic Cancer - AU(Pancreas,Australia)
ICGC-PACA-CA: Pancreatic Cancer - CA(Pancreas,Canada)
ICGC-PAEN-AU: Pancreatic Cancer Endocrine neoplasms - AU(Pancreas,Australia)
ICGC-PAEN-IT: Pancreatic Endocrine Neoplasms - IT(Pancreas,Italy)
ICGC-PBCA-DE: Pediatric Brain Cancer - DE(Brain,Germany)
ICGC-PBCA-US: Pediatric Brain Tumor - Multiple subtypes(Brain,United States)
ICGC-PEME-CA: Pediatric Medulloblastoma - CA(Brain,Canada)
ICGC-PRAD-CA: Prostate Adenocarcinoma - CA(Prostate,Canada)
ICGC-PRAD-CN: Prostate Cancer - CN(Prostate,China)
ICGC-PRAD-FR: Prostate Cancer - Adenocarcinoma(Prostate,France)
ICGC-PRAD-UK: Prostate Adenocarcinoma - UK(Prostate,United Kingdom)
ICGC-PRAD-US: Prostate Adenocarcinoma - TCGA, US(Prostate,United States)
ICGC-READ-US: Rectum Adenocarcinoma - TCGA, US(Colorectal,United States)
ICGC-RECA-CN: Renal Cancer - CN(Kidney,China)
ICGC-RECA-EU: Renal Cell Cancer - EU/FR(Kidney,European Union, France)
ICGC-RT-US: Rhabdoid Tumors - TARGET, US(Kidney,United States)
ICGC-SARC-US: Sarcoma - TCGA, US(Mesenchymal,United States)
ICGC-SKCA-BR: Skin Adenocarcinoma - BR(Skin,Brazil)
ICGC-SKCM-US: Skin Cutaneous melanoma - TCGA, US(Skin,United States)
ICGC-STAD-US: Gastric Adenocarcinoma - TCGA, US(Stomach,United States)
ICGC-THCA-CN: Thyroid Cancer - CN(Head and neck,China)
ICGC-THCA-SA: Thyroid Cancer - SA(Head and neck,Saudi Arabia)
ICGC-THCA-US: Head and Neck Thyroid Carcinoma - TCGA, US(Head and neck,United States)
ICGC-UCEC-US: Uterine Corpus Endometrial Carcinoma- TCGA, US(Uterus,United States)
ICGC-UTCA-FR: Uterine Cancer - Carcinosarcoma(Uterus,France)
ICGC-WT-US: Wilms Tumor - TARGET, US(Kidney,United States)

